[41, 42, 35, 35, 35, 35, 35, 35, 35, 35, 35, 35, 39, 40, 41, 42, 35, 35, 35, 35, 35, 35, 35, 35, 35, 35, 35, 35, 35, 35,
            35, 32, 35, 35, 35, 35, 35, 35, 4, 35, 35, 35, 35, 35, 35, 35, 35, 35, 35, 35, 35, 35, 35, 35, 35, 32, 33, 34, 35, 35,
            35, 35, 47, 48, 49, 35, 12, 13, 14, 35, 35, 35, 35, 35, 35, 35, 35, 32, 33, 34, 35, 35, 35, 35, 35, 39, 40, 41, 42, 35,
            35, 35, 35, 35, 35, 35, 35, 35, 35, 35, 35, 35, 35, 35, 35, 2, 35, 39, 40, 41, 42, 35, 35, 35, 35, 35, 35, 3, 35, 35,
            35, 35, 35, 35, 35, 35, 35, 35, 32, 33, 34, 35, 35, 35, 35, 35, 35, 35, 35, 35, 35, 35, 35, 35, 35, 35, 12, 13, 14, 35,
            35, 35, 35, 35, 35, 35, 35, 35, 39, 40, 41, 42, 35, 35, 57, 58, 59, 60, 35, 35, 35, 35, 35, 35, 35, 35, 35, 35, 35, 35,
            51, 35, 35, 35, 35, 35, 35, 35, 35, 35, 35, 35, 35, 35, 35, 35, 35, 35, 35, 35, 35, 35, 35, 57, 58, 59, 60, 35, 35, 35,
            35, 35, 35, 35, 35, 35, 35, 35, 35, 35, 35, 35, 35, 35, 2, 35, 35, 35, 35, 35, 35, 62, 35, 35, 35, 35, 35, 35, 35, 35,
            35, 35, 35, 35, 35, 35, 35, 35, 35, 35, 35, 35, 35, 35, 35, 35, 35, 35, 35, 35, 71, 9, 10, 35, 35, 35, 35, 35, 35, 35,
            35, 35, 35, 35, 35, 35, 35, 35, 35, 35, 35, 35, 35, 35, 35, 35, 57, 58, 59, 60, 78, 16, 17, 35, 35, 35, 35, 35, 35, 50,
            35, 35, 57, 58, 59, 60, 3, 35, 35, 35, 35, 35, 35, 35, 35, 35, 35, 35, 35, 35, 78, 16, 17, 35, 35, 35, 35, 2, 35, 35,
            35, 35, 35, 35, 12, 13, 14, 35, 35, 35, 35, 62, 35, 35, 35, 35, 35, 35, 35, 35, 78, 16, 17, 35, 35, 35, 35, 35, 35, 35,
            35, 35, 35, 35, 35, 35, 35, 35, 35, 35, 71, 9, 10, 35, 35, 35, 35, 35, 35, 35, 78, 16, 17, 57, 58, 59, 60, 35, 35, 35,
            35, 35, 35, 35, 35, 35, 35, 35, 35, 35, 78, 16, 17, 35, 35, 35, 62, 35, 35, 35, 78, 16, 17, 35, 35, 35, 35, 35, 35, 35,
            35, 35, 35, 35, 35, 35, 35, 35, 35, 35, 78, 16, 17, 35, 35, 71, 9, 10, 35, 35, 78, 16, 17, 35, 35, 35, 35, 35, 35, 35,
            35, 35, 35, 35, 35, 35, 62, 35, 35, 35, 78, 16, 17, 35, 35, 78, 16, 17, 35, 35, 78, 16, 17, 35, 35, 35, 35, 35, 35, 35,
            35, 35, 35, 35, 35, 71, 9, 10, 35, 35, 78, 16, 17, 35, 35, 78, 16, 17, 35, 35, 78, 16, 17, 35, 35, 35, 35, 35, 35, 35,
            35, 35, 35, 35, 35, 78, 16, 17, 35, 35, 78, 16, 17, 35, 35, 78, 16, 17, 35, 35, 78, 16, 17, 35, 35, 35, 35, 35, 35, 35,
            35, 35, 35, 35, 35, 78, 16, 17, 35, 35, 78, 16, 17, 35, 35, 78, 16, 17, 35, 35, 78, 16, 17, 35, 35, 35, 35, 35, 35, 35,
            9, 9, 9, 9, 9, 9, 9, 9, 9, 9, 9, 9, 9, 9, 9, 9, 9, 9, 9, 9, 9, 9, 9, 9, 9, 9, 9, 9, 9, 9]