[41, 42, 35, 35, 35, 35, 35, 35, 35, 35, 35, 35, 39, 40, 41, 42, 35, 35, 35, 35, 35, 35, 35, 35, 35, 35, 35, 35, 35, 35,
            35, 32, 35, 35, 35, 35, 35, 35, 35, 35, 35, 35, 35, 35, 35, 35, 35, 35, 35, 35, 35, 35, 35, 35, 35, 32, 33, 34, 35, 35,
            35, 35, 47, 48, 49, 35, 35, 35, 35, 35, 35, 35, 35, 35, 35, 35, 35, 32, 33, 34, 35, 35, 35, 3, 35, 1, 40, 41, 42, 35,
            35, 35, 1, 35, 35, 35, 35, 35, 35, 35, 35, 35, 35, 35, 35, 35, 35, 39, 40, 41, 42, 35, 35, 12, 13, 14, 35, 35, 35, 35,
            35, 12, 13, 14, 35, 35, 35, 35, 32, 33, 34, 35, 35, 35, 35, 35, 35, 35, 35, 35, 35, 35, 35, 35, 35, 35, 35, 35, 35, 35,
            35, 35, 35, 35, 35, 35, 35, 35, 39, 40, 41, 42, 35, 35, 57, 58, 59, 60, 35, 35, 35, 35, 35, 35, 35, 35, 35, 35, 35, 35,
            51, 35, 35, 35, 35, 35, 35, 35, 35, 35, 35, 35, 35, 35, 35, 35, 35, 2, 35, 35, 35, 35, 35, 57, 58, 59, 60, 35, 35, 35,
            35, 35, 35, 35, 35, 35, 35, 35, 35, 35, 35, 35, 35, 35, 35, 35, 35, 35, 35, 35, 35, 35, 35, 35, 35, 35, 35, 35, 35, 35,
            35, 35, 35, 35, 35, 35, 35, 35, 35, 4, 35, 35, 35, 35, 35, 35, 35, 35, 35, 35, 35, 35, 35, 35, 35, 35, 35, 35, 35, 35,
            35, 35, 35, 35, 35, 35, 35, 12, 13, 14, 35, 35, 35, 35, 35, 35, 57, 58, 59, 60, 35, 35, 35, 35, 35, 35, 35, 35, 35, 50,
            35, 35, 57, 58, 59, 60, 35, 35, 35, 35, 35, 35, 35, 35, 35, 35, 35, 35, 35, 35, 35, 35, 35, 35, 35, 35, 35, 35, 35, 35,
            35, 35, 35, 35, 35, 35, 35, 35, 35, 35, 35, 35, 35, 35, 35, 35, 35, 35, 35, 35, 35, 35, 35, 35, 35, 35, 35, 2, 35, 35,
            35, 35, 35, 35, 35, 35, 35, 35, 35, 35, 35, 35, 35, 35, 35, 35, 35, 35, 35, 35, 35, 35, 35, 57, 58, 59, 60, 35, 35, 35,
            35, 35, 35, 35, 35, 35, 35, 35, 35, 35, 35, 35, 35, 35, 35, 35, 35, 35, 35, 35, 35, 35, 35, 35, 35, 35, 35, 35, 35, 35,
            35, 35, 35, 35, 35, 35, 35, 35, 35, 35, 35, 35, 35, 35, 35, 35, 35, 35, 35, 35, 35, 35, 35, 35, 35, 35, 35, 35, 32, 35,
            35, 35, 35, 35, 35, 35, 35, 35, 35, 35, 35, 35, 35, 35, 35, 35, 35, 35, 35, 35, 35, 35, 35, 35, 35, 35, 35, 35, 35, 35,
            35, 35, 35, 35, 35, 35, 35, 35, 35, 35, 35, 35, 35, 35, 35, 35, 35, 35, 35, 35, 35, 35, 35, 35, 35, 35, 35, 35, 35, 35,
            35, 35, 35, 35, 35, 35, 35, 35, 35, 35, 35, 35, 35, 35, 35, 35, 35, 35, 35, 35, 35, 35, 35, 35, 35, 35, 35, 35, 35, 35,
            35, 35, 35, 35, 35, 35, 35, 62, 35, 3, 35, 62, 35, 35, 35, 62, 35, 35, 35, 62, 35, 35, 35, 35, 35, 62, 35, 62, 35, 1,
            9, 9, 9, 9, 9, 9, 9, 9, 9, 9, 9, 9, 9, 9, 9, 9, 9, 9, 9, 9, 9, 9, 9, 9, 9, 9, 9, 9, 9, 9]