[41, 42, 35, 35, 35, 35, 35, 35, 35, 35, 35, 35, 39, 40, 41, 42, 35, 35, 35, 35, 35, 35, 35, 35, 35, 35, 35, 35, 35, 35,
            35, 32, 35, 35, 35, 35, 35, 35, 35, 35, 35, 35, 35, 35, 35, 35, 35, 35, 35, 35, 35, 35, 35, 35, 35, 32, 33, 34, 35, 35,
            35, 35, 47, 48, 49, 35, 35, 35, 35, 35, 35, 35, 35, 35, 35, 35, 35, 32, 33, 34, 35, 35, 35, 35, 35, 39, 40, 41, 42, 35,
            35, 35, 1, 35, 35, 35, 35, 35, 35, 35, 35, 35, 35, 35, 35, 35, 35, 39, 40, 41, 42, 35, 35, 35, 35, 35, 35, 35, 4, 35,
            35, 35, 2, 35, 35, 35, 35, 35, 32, 33, 34, 35, 35, 35, 35, 35, 35, 35, 35, 35, 35, 35, 35, 35, 35, 35, 12, 13, 14, 35,
            35, 35, 35, 35, 35, 35, 35, 35, 39, 40, 41, 42, 35, 35, 57, 58, 59, 60, 35, 35, 35, 35, 35, 35, 35, 35, 35, 35, 35, 35,
            51, 35, 35, 35, 35, 35, 35, 35, 35, 35, 35, 35, 35, 35, 35, 35, 35, 35, 35, 35, 35, 35, 35, 57, 58, 59, 60, 35, 35, 35,
            35, 35, 35, 35, 35, 35, 35, 3, 35, 35, 35, 35, 35, 35, 35, 35, 35, 35, 35, 35, 35, 35, 35, 35, 35, 35, 35, 35, 35, 35,
            35, 35, 35, 35, 35, 35, 35, 2, 35, 35, 35, 35, 35, 35, 35, 35, 35, 35, 35, 35, 35, 35, 35, 35, 35, 35, 35, 35, 35, 35,
            35, 35, 35, 35, 35, 35, 35, 35, 35, 35, 35, 35, 35, 35, 35, 35, 57, 58, 59, 60, 35, 35, 35, 35, 35, 35, 35, 35, 35, 50,
            35, 35, 57, 58, 59, 60, 35, 35, 35, 35, 35, 35, 35, 4, 35, 35, 35, 35, 62, 35, 3, 35, 35, 62, 35, 35, 35, 35, 35, 35,
            35, 35, 35, 35, 35, 35, 35, 35, 35, 35, 35, 35, 12, 13, 14, 35, 71, 9, 9, 9, 9, 9, 9, 9, 9, 9, 9, 9, 9, 9,
            35, 35, 35, 35, 35, 35, 35, 35, 35, 35, 35, 35, 35, 35, 35, 35, 78, 16, 16, 16, 16, 16, 16, 16, 16, 16, 16, 16, 16, 16,
            35, 35, 35, 35, 35, 35, 35, 35, 35, 35, 35, 35, 35, 35, 35, 35, 78, 16, 16, 16, 16, 16, 16, 16, 16, 16, 16, 16, 16, 16,
            35, 35, 35, 35, 35, 35, 35, 35, 35, 35, 35, 35, 35, 35, 35, 35, 85, 23, 23, 23, 23, 23, 23, 23, 23, 23, 23, 23, 23, 23,
            35, 35, 35, 35, 35, 35, 35, 35, 35, 35, 35, 35, 35, 35, 35, 35, 82, 20, 20, 20, 20, 20, 20, 20, 20, 20, 20, 20, 20, 20,
            35, 35, 35, 35, 35, 35, 35, 35, 35, 35, 35, 35, 35, 35, 35, 35, 89, 27, 27, 27, 27, 27, 27, 27, 27, 27, 27, 27, 27, 27,
            35, 35, 35, 35, 35, 35, 35, 35, 35, 35, 35, 35, 35, 35, 35, 35, 89, 27, 27, 27, 27, 27, 27, 27, 27, 27, 27, 27, 27, 27,
            35, 35, 4, 35, 35, 35, 62, 35, 35, 35, 35, 35, 62, 35, 4, 35, 89, 27, 27, 27, 27, 27, 27, 27, 27, 27, 27, 27, 27, 27,
            9, 9, 9, 9, 9, 9, 9, 9, 9, 9, 9, 9, 9, 9, 9, 9, 9, 9, 9, 9, 9, 9, 9, 9, 9, 9, 9, 9, 9, 9]