[41, 42, 35, 35, 35, 35, 35, 35, 35, 35, 35, 35, 39, 40, 41, 42, 35, 35, 35, 35, 35, 35, 35, 35, 35, 35, 35, 35, 35, 35,
            35, 32, 35, 35, 35, 35, 35, 35, 35, 35, 35, 35, 35, 35, 35, 35, 35, 35, 35, 35, 35, 35, 35, 35, 35, 32, 33, 34, 35, 35,
            35, 35, 47, 48, 49, 35, 35, 35, 5, 35, 62, 35, 35, 35, 35, 35, 35, 32, 33, 34, 35, 35, 35, 35, 35, 39, 40, 41, 42, 35,
            35, 35, 35, 35, 35, 35, 35, 75, 13, 13, 13, 13, 13, 14, 35, 35, 35, 39, 40, 41, 42, 35, 35, 35, 35, 35, 35, 35, 35, 35,
            35, 35, 35, 35, 35, 35, 35, 63, 32, 33, 34, 35, 35, 35, 35, 2, 35, 35, 35, 35, 35, 35, 35, 35, 35, 35, 35, 35, 35, 35,
            35, 35, 35, 35, 35, 35, 35, 63, 39, 40, 41, 42, 35, 35, 35, 35, 35, 2, 35, 62, 35, 35, 35, 35, 35, 35, 35, 35, 35, 35,
            51, 35, 35, 35, 35, 35, 35, 63, 35, 35, 35, 35, 35, 35, 35, 35, 35, 35, 35, 2, 35, 35, 35, 57, 58, 59, 60, 35, 35, 35,
            35, 35, 35, 35, 35, 35, 35, 63, 35, 35, 35, 35, 35, 35, 35, 35, 35, 35, 35, 35, 35, 2, 35, 35, 35, 35, 35, 35, 35, 35,
            35, 35, 35, 35, 35, 35, 35, 63, 35, 35, 35, 35, 35, 35, 35, 35, 35, 35, 35, 35, 35, 35, 35, 2, 35, 35, 35, 35, 35, 35,
            35, 35, 35, 35, 35, 35, 35, 63, 35, 35, 35, 12, 13, 14, 35, 35, 57, 58, 59, 60, 35, 35, 35, 35, 35, 8, 9, 9, 9, 9,
            35, 35, 57, 58, 59, 60, 62, 63, 35, 35, 35, 35, 35, 35, 35, 35, 35, 35, 35, 35, 35, 35, 35, 35, 35, 15, 16, 16, 16, 16,
            35, 35, 12, 76, 13, 13, 13, 14, 35, 35, 35, 35, 35, 35, 35, 35, 35, 35, 35, 35, 35, 35, 35, 35, 35, 22, 23, 23, 23, 23,
            35, 35, 35, 63, 35, 35, 35, 35, 35, 35, 32, 33, 34, 35, 35, 35, 35, 35, 11, 35, 35, 35, 35, 35, 35, 19, 20, 20, 20, 20,
            35, 35, 35, 63, 35, 35, 35, 35, 35, 35, 39, 40, 41, 42, 35, 35, 35, 35, 18, 35, 32, 33, 34, 35, 35, 26, 27, 27, 27, 27,
            35, 35, 35, 63, 35, 35, 35, 35, 35, 35, 35, 35, 35, 35, 35, 35, 35, 35, 25, 35, 39, 40, 41, 42, 35, 26, 27, 27, 27, 27,
            35, 35, 35, 63, 35, 35, 35, 35, 35, 35, 35, 35, 35, 35, 35, 35, 35, 35, 35, 35, 35, 35, 35, 35, 35, 26, 27, 27, 27, 27,
            35, 35, 35, 63, 35, 35, 35, 35, 35, 35, 35, 35, 35, 35, 35, 35, 35, 35, 35, 35, 35, 35, 35, 35, 35, 26, 27, 27, 27, 27,
            35, 35, 35, 63, 35, 35, 35, 35, 35, 35, 35, 35, 35, 35, 35, 35, 35, 35, 35, 35, 35, 35, 35, 35, 35, 26, 27, 27, 27, 27,
            35, 35, 35, 63, 7, 35, 35, 4, 35, 35, 35, 35, 35, 35, 3, 35, 35, 35, 35, 35, 4, 35, 62, 35, 35, 26, 27, 27, 27, 27,
            9, 9, 9, 9, 9, 9, 9, 9, 9, 9, 9, 9, 9, 9, 9, 9, 9, 9, 9, 9, 9, 9, 9, 9, 9, 9, 9, 9, 9, 9]