[41, 42, 35, 35, 35, 35, 35, 35, 35, 35, 35, 35, 39, 40, 41, 42, 35, 35, 35, 35, 35, 35, 35, 35, 35, 35, 35, 35, 35, 35,
            35, 32, 35, 35, 35, 35, 35, 35, 35, 35, 35, 35, 35, 35, 35, 35, 35, 35, 35, 35, 35, 35, 35, 35, 35, 32, 33, 34, 35, 35,
            35, 35, 47, 48, 49, 35, 35, 2, 35, 35, 35, 35, 35, 35, 35, 35, 35, 32, 33, 34, 35, 35, 35, 35, 35, 39, 40, 41, 42, 35,
            35, 35, 35, 35, 35, 35, 35, 35, 35, 35, 35, 35, 35, 35, 35, 35, 35, 39, 40, 41, 42, 35, 35, 35, 35, 35, 35, 35, 2, 35,
            35, 35, 35, 35, 35, 35, 35, 35, 32, 33, 34, 35, 35, 35, 35, 35, 35, 35, 35, 35, 35, 35, 35, 35, 35, 35, 35, 35, 35, 35,
            35, 35, 35, 35, 35, 35, 35, 35, 39, 40, 41, 42, 35, 35, 35, 35, 35, 35, 35, 35, 35, 35, 35, 35, 35, 35, 35, 35, 35, 35,
            51, 35, 35, 35, 35, 35, 35, 35, 35, 35, 35, 35, 35, 35, 35, 35, 35, 35, 35, 35, 35, 35, 35, 57, 58, 59, 60, 35, 35, 35,
            35, 35, 35, 35, 35, 35, 35, 35, 35, 35, 35, 35, 35, 35, 35, 35, 35, 35, 35, 35, 35, 35, 35, 35, 35, 35, 35, 35, 35, 35,
            35, 35, 35, 35, 35, 35, 3, 35, 35, 35, 62, 35, 3, 35, 35, 62, 35, 35, 35, 35, 62, 35, 4, 35, 35, 62, 35, 35, 35, 35,
            9, 9, 9, 72, 9, 9, 9, 9, 73, 35, 11, 35, 8, 10, 35, 11, 35, 8, 10, 35, 11, 35, 8, 10, 35, 11, 35, 2, 35, 35,
            16, 16, 16, 79, 16, 16, 16, 16, 80, 35, 18, 35, 15, 17, 35, 18, 35, 15, 17, 35, 18, 35, 15, 17, 35, 18, 35, 35, 35, 35,
            23, 23, 23, 86, 23, 23, 16, 16, 80, 35, 25, 35, 22, 24, 35, 25, 35, 22, 24, 35, 25, 35, 22, 24, 35, 25, 35, 35, 35, 35,
            35, 35, 35, 63, 35, 35, 15, 16, 80, 35, 32, 33, 34, 35, 35, 35, 35, 35, 35, 35, 35, 35, 35, 35, 35, 35, 35, 35, 35, 35,
            35, 62, 35, 63, 35, 4, 22, 23, 87, 35, 39, 40, 41, 42, 35, 35, 35, 1, 35, 35, 32, 35, 35, 35, 35, 35, 35, 35, 35, 4,
            13, 13, 13, 76, 13, 13, 13, 13, 13, 13, 13, 13, 13, 13, 13, 13, 13, 13, 13, 13, 13, 13, 13, 13, 13, 13, 13, 13, 13, 13,
            35, 35, 35, 63, 35, 35, 35, 35, 35, 35, 35, 35, 35, 35, 35, 35, 35, 35, 35, 35, 35, 35, 35, 35, 35, 35, 35, 35, 35, 35,
            35, 35, 35, 63, 35, 35, 35, 35, 35, 35, 35, 35, 35, 35, 35, 35, 35, 35, 35, 35, 35, 35, 35, 35, 35, 35, 35, 35, 35, 35,
            35, 35, 35, 63, 35, 35, 35, 35, 35, 35, 35, 35, 35, 35, 35, 35, 35, 35, 35, 35, 35, 35, 35, 35, 35, 35, 35, 35, 35, 35,
            35, 4, 35, 63, 35, 35, 35, 35, 35, 35, 35, 35, 35, 35, 1, 35, 35, 35, 35, 35, 35, 35, 35, 35, 35, 4, 35, 35, 35, 35,
            9, 9, 9, 9, 9, 9, 9, 9, 9, 9, 9, 9, 9, 9, 9, 9, 9, 9, 9, 9, 9, 9, 9, 9, 9, 9, 9, 9, 9, 9]